WWWWWWWWWWWWWWWWW
WFFFFFFWFFFFFFFWW
WFFFFFFWFFFFFFFF2
WFFFFFFFFFFFFFFF2
WFFFFFFFFFFFFFFF2
WFFFFFFWFFFFFFFWW
WFFFFFFWFFFFFFFWW
WWWFFWWWWWWWFFFWW
WFFFFFFFFFFWFFFWW
WFFFFFFFFFFWFFFWW
WFFFFFFFFFFWFFFWW
WFFFFFFFFFFWFFFWW
WFFFFFFFFFFWFFFWW
WFFFFFFFFFFFFFFWW
WFFFFFFFFFFFFFFWW
WWWWWWWWWWWWWWWWW
