WWWWWWW11111111111WWWWWWW
WFFFFFFFFFFFFFFFFFFFFFFFW
WFFFFFFFFFFFFFFFFFFFFFFFW
WFFFFFFFFFFFFFFFFFFFFFFFW
WFFFFFFFFFFFFFFFFFFFFFFFW
WFFFFFFFFFFFFFFFFFFFFFFFW
WFFFFFFFFFFFFFFFFFFFFFFFW
WWWWWWWFFFFFFFFFFFWWWWWWW
WWWWWWW33333333333WWWWWWW
WWWWWWWWWWWWWWWWWWWWWWWWW