zzzzzzzzzzzzzzzzzzzzW11111111Wzz
zWWWWWWWWWWWWWWWWWWWWFFFFFFFFWzz
zWFFFFFFFFFFFFFFFFFFFFFFFFFFFWzz
zWFFFFFFFFFFFFFFFFFFFFFFFFFFFWzz
zWFFFFFFFFFFFFFFFFFFFFFFFFFFFWzz
zWFFFWFFWWWFFWWWFFFFFFFFFFFFFWzz
zWFFFWFFFFFFFFFFFFFFFFFFFFFFFWzz
WWFFFWFFFFFFFFFFFFFFFFFFFFFFFWzz
4FFFFWFFFFFFFFFFFFFFFFWWWWFFFWWW
4FFFFFFFFFFFFFFFFFFFFFWzWFFFFFF2
4FFFFFFFFFFFFFFFFFFFFFWzWFFFFFF2
4FFFFFFFFFFFFFFFFFFFFFWzWFFFFFF2
4FFFFFFFFFFFFFFFFFFFFFWzWWFFFFF2
WFFFFWFFFFFFFFFFFFFFFFWWWWFFFWWW
WWFFFWFFFFFFFFFFFFFFFFFFFFFFFWzz
zWFFFWFFFFFFFFFFFFFFFFFFFFFFFWzz
zWFFFWFFFFFFFFFFFFFFFFFFFFFFFWzz
zWFFFFFFWWWFFWWWFFFFFFFFFFFFFWzz
zWFFFFFFFFFFFFFFFFFFFFFFFFFFFWzz
zWFFFFFFFFFFFFFFFFFFFFFFFFFFFWzz
zWFFFFFFFFFFFFFFFFFFFFFFFFFFFWzz
zWWWWWWWWWWWWWWFFFFFFFFWWWWWWWzz
zzzzzzzzzzzzzzWFFFFFFFFWzzzzzzzz
zzzzzzzzzzzzzzW33333333Wzzzzzzzz
zzzzzzzzzzzzzzWWWWWWWWWWzzzzzzzz