zzzzzzzzzzzzW111111WWzzzzzzzzzzz
WWWWWWWWWWWWWFFFFFFWWWWWWWWWWWWW
WFFFFFFFWFFFFFFFFFFFFFFFFFFWFFF6
WFFFFFFFWFFFFFFFFFFFFFFFFFFWFFF6
8FFFFFFFWFFFFFFFFFFFFFFFFFFWFFF6
8FFFFFFFWFFFFFFFFFFFFFFFFFFWFFF6
8FFFFFFFWFFFFFFFFFFFFFFFFFFWFFF6
8FFFFFFFWFFFFFFFFFFFFFFFFFFWFFF6
8FFFFFFFWFFFFFFFFFFFFFFFFFFWFFF6
8FFFFFFFWWWFFFFFWWWFFFFFWWWWFFF6
WFFFFFFFFFFFFFFFFFFFFFFFFFFFFFFW
WFFFFFFFFFFFFFFFFFFFFFFFFFFFFFFW
WFFFFFFFFFFFFFFFFFFFFFFFFFFFFFFW
WFFFFFFFFFFFFFFFFFFFFFFFFFFFFFFW
WFFFFFFFFFFFFFFFFFFFFFFFFFFFFFFW
WFFFFFWWWWWWWFFFFFFWWWWWWWFFFFF2
WFFFFFWzzzzzWFFFFFFWzzzzzWFFFFF2
WFFFFFWzzzzzWFFFFFFWzzzzzWFFFFF2
WFFFFFWzzzzzWFFFFFFWzzzzzWFFFFF2
WFFFFFWWWWWWWFFFFFFWWWWWWWFFFFF2
WFFFFFFFFFFFFFFFFFFFFFFFFFFFFFF2
WFFFFFFFFFFFFFFFFFFFFFFFFFFFFFF2
WFFFFFFFFFFFFFFFFFFFFFFFFFFFFFF2
WWWWWWWWWWWWWWWWWWWWWWWWWWWWWWWW
WWWWWWWWWWWWWWWWWWWWWWWWWWWWWWWW