zzzzzzzzzzzzzzzzzzzzzzW11111Wzzz
zWWWWWWWWWWWWWWWWWWWWWWFFFFFWWWW
zWFFFFFFFFFFWWWFFFFWWWFFFFFFFFFW
zWWWWFFFFFFFFFFFFFFFFFFFFFFFFFFW
zWFFFFFFFFFFFFFFFFFFFFFFFFFFFFFW
zWFFFFFFFFFFFFFFFFFFFFFFFFFFFFFW
zWWWWFFFFFFFWWWWWWWWWWFFFFFFWWWW
zWWWWWFFFFWWWWWWWWWWWWWFFFFFWWWW
zWWWWFFFFFFFWWFFFFFFFFFFFFFFFFFW
zWWWWFFFFFFFWWFFFFFFFFFFFFFFFFFW
zWFFFFFFFFFFWWFFFFFFFFFFFFFFFFFW
zWFFFFFFFFFFWWFFFFFFFFFFFFFFFFFW
zWFFFFFFFFFFWWWFFFFFFWFFFFFFWWWW
zWFFFFFFFFFFWWWWFFFFWWWFFFFFWWWW
zWWWWFFFFFFFFFFFFFFFFFFFFFFFFFFW
zWFFFFFFFFFFFFFFFFFFFFFFFFFFFFFW
zWFFFFFFFFFFFFFFFFFFFFFFFFFFFFFW
zWFFFFFFFFFWWWWFFFFWWWWFFFFFFFFW
zWFFFFFFFFFFFFFFFFFFFFFFFFFFFFFW
zWWWWFFFFFFFFFFFFFFFFFFFFFFFFFFW
zWWWWFFFFFFFFFFFFFFFFFFFFFFFFFFW
zWWWWWWWWWWWWWWWWWWWWWWFFFFFWWWW
zzzzzzzzzzzzzzzzzzzzzzWFFFFFWzzz
zzzzzzzzzzzzzzzzzzzzzzW33333Wzzz
zzzzzzzzzzzzzzzzzzzzzzzzzzzzzzzz