zzzzzzzzzzzzW111111Wzzzzzzzzzzzz
WWWWWWWWWWWWWFFFFFFWWWWWWWWWWzzz
8FFFFFFFFFFFFFFFFFFFFFFFFFFFWzzz
8FFFFFFFFFFFFFFFFFFFFFFFFFFFWzrr
8FFFFFFFFFFFFFFFFFFFFFFFFFFFWzrr
8FFFFFFFFFFFFFFFFFFFFFFFFFFFWzrr
8FFFFFFFFFFFFFFFFFFFFFFFFFFFWzrr
8FFFFFFFFFFFFFFFFFFFFFFFFFFFWzrr
8FFFFFFFFFFFFFFFFFFFFFFFFFFFWzrr
8FFFFWWWWWWWWWWWWWWFFFFWWWWWWzrr
WFFFFWzzzzzzzzzzzzWFFFFWzzzzzzrr
WFFFFWzrrrrrrrrrrzWFFFFWzzzzzzrr
WFFFFWzrrrrrrrrrrzWFFFFWzrrrrrrr
WFFFFWzrrrrrrrrrrzWFFFFWzrrrrrrr
WFFFFWzrrrrrrrrrrzWFFFFWzrrrrrrr
4FFFFWWWWWWWWWWWWWWFFFFWWWWWWzrr
4FFFFFFFFFFFFFFFFFFFFFFFFFFFWzrr
4FFFFFFFFFFFFFFFFFFFFFFFFFFFWzrr
4FFFFFFFFFFFFFFFFFFFFFFFFFFFWzrr
4FFFFFFWWWWWWWWWWWWWWWWWFFFFWzrr
4FFFFFFFFFFFFFFFFFFFFFFFFFFFWzrr
4FFFFFFFFFFFFFFFFFFFFFFFFFFFWzrr
4FFFFFFFFFFFFFFFFFFFFFFFFFFFWzrr
WWWWWWWWWWWWWWWWWWWWWWWWWWWWWWWW
WWWWWWWWWWWWWWWWWWWWWWWWWWWWWWWW