zzzzzzzzzzzzW111111Wzzzzzzzzzzzz
WWWWWWWWWWWWWFFFFFFWWWWWWWWWWWWW
WFFFFFFFFFFFFFFFFFFFFFFFFFFFFFF2
WFFFFFFFFFFFFFFFFFFFFFFFFFFFFFF2
WFFFFFFFFFFFFFFFFFFFFFFFFFFFFFF2
WFFFFFFFFFFFFFFFFFFFFFFFFFFFFFF2
WFFFFFFFFFFFFFFFFFFFFFFFFFFFFFF2
WFFFFFFFFFFFFFFFFFFFFFFFFFFFWWWW
WFFFFFFFFFFFFFFFFFFFFFFFFFFWWzzz
WFFFFFFFFFFFFFFFFFFFFFFFFFFWzzzz
WFFFFFFFFFFFFFFFFFFFFFFFFFFWzzzz
WFFFFFFFFFFFFFFFFFFFFFFFFFFWzzzz
WFFFFFFFFFFFFFFFFFFFFFFFFFFWzzzz
WFFFFFFFFFFFFFFFFFFFFFFFFFFWzzzz
WFFFFFFFFFFFFFFFFFFFFFFFFFFWzzzz
WFFFFFFFFFFFFFFFFFFFFFFFFFFWzzzz
WFFFFFFFFFFFFFFFFFFFFFFFFFFWWWWW
WFFFFFFFFFFFFFFFFFFFFFFFFFFFFFF6
WFFFFFFFFFFFFFFFFFFFFFFFFFFFFFF6
WFFFFFFFFFFFFFFFFFFFFFFFFFFFFFF6
WFFFFFFFFFFFFFFFFFFFFFFFFFFFFFF6
WFFFFFFFFFFFFFFFFFFFFFFFFFFFFFF6
WFFFFFFFFFFFFFFFFFFFFFFFFFFFWWWW
WWWWWWWWWWWWWWWWWWWWWWWWWWWWWzzz
WWWWWWWWWWWWWWWWWWWWWWWWWWWWWWWW