zzzzzzzzzzzzzzzzzzzzzzzzzzzzzzzz
zzWWWWWWWWWWWWWWWWWWWWWWWWWWWWzz
zzWFFFFFFFFFFFFFFFFFFFFFFFFFFWWz
zzWFFFFFFFFFFFFFFFFFFFFFFFFFFWWz
zzWFFFFFFFFFFFFFFFFFFFFFFFFFFFWz
zzWFFFFFFFFFFFFFFFFFFFFFFFFFFFWz
zzWFFFFFFFFFFFFFFFFFFFFFFFFFFFWz
WWWFFFFFFFFFFFFFFFFFFFFFFFFFFFWz
4FFFFFFFFFFFFFFFFFFFFFFFFFFFFFWz
4FFFFFFFFFFFFFFFFFFFFFFFFFFFFFWz
4FFFFFFFFFFFFFFFFFFFFFFFFFFFFFWz
4FFFFFFFFFFFFFFFFFFFFFFFFFFFFFWz
4FFFFFFFFFFFFFFFFFFFFFFFFFFFFFWz
WWFFFFFFFFFFFFFFFFFFFFFFFFFFFFWz
zWWFFFFFFFFFFFFFFFFFFFFFFFFFFFWz
zzWFFFFFFFFFFFFFFFFFFFFFFFFFFFWz
zzWFFFFFFFFFFFFFFFFFFFFFFFFFFFWz
zzWFFFFFFFFFFFFFFFFFFFFFFFFFFFWz
zzWFFFFFFFFFFFFFFFFFFFFFFFFFFFWz
zzWFFFFFFFFFFFFFFFFFFFFFFFFFFFWz
zzWFFFFFFFFFFFFFFFFFFFFFFFFFFFWz
zzWWFFFFFFFFFFFFFFFFFFFFFFFFFFWz
zzzWFFFFFFFFFFFFFFFFFFFFFFFFFFWz
zzWWWWWWWWWWWWWWWWWWWWWWWWWWWWzz
zzWWWWWWWWWWWWWWWWWWWWWWWWWWWzzz