zzzW111111WzzzzWWWWWWWWWzzzzzzzz
zzzWFFFFFFWWWWWWFFFFFFFWFFFzzzzz
zzWWFFFFFFFFFFFFFFFFFFFWWWWWWzzz
zzWFFFFFFFFFFFFFFFFFFFFFFFFFWWWW
zzWWWWWFFFFFFFFFFFFFFFFFFFFFFFF2
zzWFFFFFFFFFFFFFFFFFFFFFFFFFFFF2
zzWFFFFFFFFFFFFFFFFFFFFFFFFFFFF2
zzWFFFFFFFFFFFFFFFFFFFFFFFFFFFF2
zzWFFFFFWWWWFFFFFFFFWWWWFFFFFFF2
zzWFFFFFFFFFFFFFFFFFWFFFFFFFFWWW
zzWFFFFFFFFFFFFFFFFFWFFFFFFFFWzz
zzWFFFFFFFFFFFFFFFFFWFFFFFFFFWzz
zzWFFFFWWWWWFFFFWWWWWFFFFWWWWWzz
zzWFFFFFFFFWFFFFFFFFWFFFFFFFFWzz
zzWFFFFFFFFWFFFFFFFFWFFFFFFFFWzz
zzWFFFFFFFFWFFFFFFFFWFFFFFFFFWzz
zzWFFFFWFFFWFFFFFFFFWFFFWFFFFWzz
zzWFFFFWFFFWFFFFFFFFWFFFWFFFFWzz
zzWFFFFWFFFWFFFFFFFFWFFFWFFFFWzz
zzWFFFFFFFFFFFFFFFFFFFFFFFFFFWzz
zzWFFFFFFFFFFFFFFFFFFFFFFFFFFWzz
zzWFFFFFFFFFFFFFFFFFFFFFFFFFFWzz
zzWWWWWWWWWWFFFFFFFFFWWWWWWWWWzz
zzzzzzzzzzzW333333333Wzzzzzzzzzz
zzzzzzzzzzzWWWWWWWWWWWzzzzzzzzzz