zzzzzzzzzzzzW1111111Wzzzzzzzzzzz
zzWWWWWWWWWWWFFFFFFFWWWWWWWWWWzz
zzWFFFFFFFFFFFFFFFFFFFFFFFFFFWzz
zzWFFFFFFFFFFFFFFFFFFFFFFFFFFWzz
zzWFFFFFFFFFFFFFFFFFFFFFFFFFFWzz
zzWFFFFFFFFFFFFFFFFFFFFFFFFFFWzz
zzWFFFFFWWWFFFFFFFFFFFFWWWWWWWzz
zzWFFFFFWzWFFFFFFFFFFFWzzzzzzzzz
WWWFFFFFWWWFFFFFFFFFFFWWWWWWWWWW
4FFFFFFFFFFFFFFFFFFFFFFFFFFFFFF2
4FFFFFFFFFFFFFFFFFFFFFFFFFFFFFF2
4FFFFFFFFFFFFFFFFFFFFFFFFFFFFFF2
4FFFFFFFFFFFFFFFFFFFFFFFFFFFFFF2
WWWFFFFFWWWFFFFFFFFFFFFWWWWWWWWW
zzWFFFFFWzWFFFFFFFFFFFWzzzzzzzzz
zzWFFFFFWWWFFFFFFFFFFFWWWWWWWWzz
zzWFFFFFFFFFFFFFFFFFFFFFFFFFFWzz
zzWFFFFFFFFFFFFFFFFFFFFFFFFFFWzz
zzWFFFFFFFFFFFFFFFFFFFFFFFFFFWzz
zzWFFFFFFFFFFFFFFFFFFFFFFFFFFWzz
zzWWWWWWWWFFFFFFFFFFFFFWWWWWWWzz
zzzzzzzzzzWFFFFFFFFFFFWzzzzzzzzz
zzzzzzzzzzWFFFFFFFFFFFWzzzzzzzzz
zzzzzzzzzzW33333333333Wzzzzzzzzz
zzzzzzzzzzWWWWWWWWWWWWWzzzzzzzzz