WWWWWWWWWWWWWWWWWWWWWWWWWWWWWWWW
WFFFFFFFFFFFFFFFFFFFFFFFFFFFFFFW
WFFFFFFFFFFFFFFFFFFFFFFFFFFFFFFW
WFFFFFFFFFFFFFFFFFFFFFFFFFFFFFFW
4FFFFFWWWWWFFFWWWWFFFWWWWWFFFFFW
4FFFFFWWWWWFFFWWWWFFFWWWWWFFFFFW
4FFFFFFFFFFFFFFFFFFFFFFFFFFFFFFW
4FFFFFFFFFFFFFFFFFFFFFFFFFFFFFFW
4FFFFFFFFFFFFFFFFFFFFFFFFFFFFFFW
WFFFWWWWWFFFWWFFFFWWWFFFWWWWFFFW
WFFFWWWWWFFFWWFFFFWWWFFFWWWWFFFW
WFFFFFFFFFFFWWFFFFFWWFFFFFFFFFFW
WFFFFFFFFFFFWWFFFFFWWFFFFFFFFFFW
WFFFFFFFFFFFWWFFFFFWWFFFFFFFFFFW
WFFFWWWWWFFFFFFFFFFFFFFFWWWWFFFW
WFFFWWWWWFFFFFFFFFFFFFFFWWWWFFFW
WFFFFFFFFFFFFFFFFFFFFFFFFFFFFFFW
WFFFFFFFFFFFWWWWWWWWWFFFFFFFFFFW
WWFFFFFFFFFWWWWWWWWWWFFFFWWWWWWW
WWWWWWWWWWWWWFFFFFFFFFFFFFFFFFFW
WFFFFFFFFFFFFFFFFFFFFFFFFFFFFFFW
WFFFFFFFFFFFFFFFFFFFFFFFFFFFFFFW
WWWWWWWWWWWWWFFFFFFFWWWWWWWWWWWW
zzzzzzzzzzzzW3333333Wzzzzzzzzzzz
WWWWWWWWWWWWWWWWWWWWWWWWWWWWWWWW