zzzzzzzzzzzzzzzzzzzzzzzzzzzzzzzz
zWWWWWWWWWWWWWWWWWWWWWWWWWWWWWWz
WWFFFFWFFFFFFFFFFFFFFFFWFFFFFFWz
4FFFFFWFFFFFFFFFFFFFFFFWFFFFFFWz
4FFFFFWFFFFFFFFFFFFFFFFWFFFFFFWW
4FFFFFWFFFFFFFFFFFFFFFFFFFFFFFF2
4FFFFFWFFFFFFFFFFFFFFFFFFFFFFFF2
WFFFFFWFFFFFFFFFFFFFFFFFFFFFFFF2
WWFFFFWFFFFFFFFFFFFFFFFWFFFFFFF2
zWFFFFFFFFFFFFFFFFFFFFFWFFFFFFF2
zWFFFFFFFFFFFFFFFFFFFFFWFFFFFFFW
zWFFFFFFFFFFFFFFFFFFFFFWFFFFFFWz
zWFFFFWWWFFFWWWWWWWWFFFWFFFFFFWz
zWFFFFFFFFFFFFFFFFFFFFFFFFFFFFWz
zWFFFFFFFFFFFFFFFFFFFFFFFFFFFFWz
zWFFFFFFFFFFFFFFFFFFFFFFFFFFFFWz
zWFFFFFFWWWWWWWWWFFFFFFFFFFFFWWz
zWFFFFFFWzzzzzzzWFFFFWWWFFFFFWzz
zWFFFFFFWzzzzzzzWFFFFWzWFFFFFWzz
zWFFFFFFWWWWWWWWWFFFFWzWFFFFFWzz
zWFFFFFFFFFFFFFFFFFFFWzWFFFFFWzz
zWWFFFFFFFFFFFFFFFFFFWzWFFFFFWzz
zzWFFFFFFFFFFFFFFFFFFWzWFFFFFWzz
zzWWWWWWWWWWWWWWWWWWWWzW33333Wzz
zzzzzzzzzzzzzzzzzzzzzzzzzzzzzzzz